#8 5x5 4
. . . . B
A F | F *
C . . . A
. . . . .
C B . . .