#8 5x5 4
A - - - A
B C - - .
| . - D |
| | * * |
B D * * C