#1 5x5 4
A - . . A
B C . - .
. . - D .
| . C * .
B D . . .