#6 5x5 3
A . . . B
. . C . .
. . C . .
. . . . B
. . . A *