#5 5x5 1
A . . . d
. a . . .
. d . . d
. . . e .
. . . . A