#4 5x5 3
A . - . .
. . - . .
. C - . C
. . - . A
B . - . B
