#2 5x5 5
A B . B C
. D . . .
. A * . .
. E * . .
E D . . C