#7 5X5 3
A . . . B
. . . . .
. B . . .
. C . C A
. . . . .